Age,Cyto,HPV,Cotest,Total test,Primary,Colpo,CIN2 detected,CIN3 detected,CIN3+ detected,Screening CC,fp,Precancer treatment,Screening colpo,Surveillance colpo,colpo3year,colpo1year,Repeat test,Normal test,Cancer,Cancer death,CancerInitialYoung,CancerInitialOld,CancerOngoing,CancerDeathYoung,CancerDeathOld,Stage1year1,Stage1year2+,Stage2-3year1,Stage4year1,Stage2+year2,Stage2+year3+,Population
1,0,0,0,0,0,0,0,0,0,0,0,0,0,0,0,0,0,0,0,0,0,0,0,0,0,0,0,0,0,0,0,0
2,0,0,0,0,0,0,0,0,0,0,0,0,0,0,0,0,0,0,0,0,0,0,0,0,0,0,0,0,0,0,0,0
3,0,0,0,0,0,0,0,0,0,0,0,0,0,0,0,0,0,0,0,0,0,0,0,0,0,0,0,0,0,0,0,0
4,0,0,0,0,0,0,0,0,0,0,0,0,0,0,0,0,0,0,0,0,0,0,0,0,0,0,0,0,0,0,0,0
5,0,0,0,0,0,0,0,0,0,0,0,0,0,0,0,0,0,0,0,0,0,0,0,0,0,0,0,0,0,0,0,0
6,0,0,0,0,0,0,0,0,0,0,0,0,0,0,0,0,0,0,0,0,0,0,0,0,0,0,0,0,0,0,0,0
7,0,0,0,0,0,0,0,0,0,0,0,0,0,0,0,0,0,0,0,0,0,0,0,0,0,0,0,0,0,0,0,0
8,0,0,0,0,0,0,0,0,0,0,0,0,0,0,0,0,0,0,0,0,0,0,0,0,0,0,0,0,0,0,0,0
9,0,0,0,0,0,0,0,0,0,0,0,0,0,0,0,0,0,0,0,0,0,0,0,0,0,0,0,0,0,0,0,99989
10,0,0,0,0,0,0,0,0,0,0,0,0,0,0,0,0,0,0,0,0,0,0,0,0,0,0,0,0,0,0,0,99978
11,0,0,0,0,0,0,0,0,0,0,0,0,0,0,0,0,0,0,0,0,0,0,0,0,0,0,0,0,0,0,0,99967
12,0,0,0,0,0,0,0,0,0,0,0,0,0,0,0,0,0,0,0,0,0,0,0,0,0,0,0,0,0,0,0,99953
13,0,0,0,0,0,0,0,0,0,0,0,0,0,0,0,0,0,0,0,0,0,0,0,0,0,0,0,0,0,0,0,99933
14,0,0,0,0,0,0,0,0,0,0,0,0,0,0,0,0,0,0,0,0,0,0,0,0,0,0,0,0,0,0,0,99907
15,0,0,0,0,0,0,0,0,0,0,0,0,0,0,0,0,0,0,0,0,0,0,0,0,0,0,0,0,0,0,0,99870
16,0,0,0,0,0,0,0,0,0,0,0,0,0,0,0,0,0,0,0,0,0,0,0,0,0,0,0,0,0,0,0,99828
17,0,0,0,0,0,0,0,0,0,0,0,0,0,0,0,0,0,0,0,0,0,0,0,0,0,0,0,0,0,0,0,99785
18,0,0,0,0,0,0,0,0,0,0,0,0,0,0,0,0,0,0,0,0,0,0,0,0,0,0,0,0,0,0,0,99742
19,0,0,0,0,0,0,0,0,0,0,0,0,0,0,0,0,0,0,0,0,0,0,0,0,0,0,0,0,0,0,0,99699
20,0,0,0,0,0,0,0,0,0,0,0,0,0,0,0,0,0,0,0,0,0,0,0,0,0,0,0,0,0,0,0,99657
21,102589,6836,0,109425,99596,9093,2507,503,503,0,6083,3010,8787,306,0,0,2993,2687,0,0,0,0,0,0,0,0,0,0,0,0,0,99615
22,8961,0,0,8961,0,1157,200,18,18,0,939,218,0,1157,0,0,8961,7804,0,0,0,0,0,0,0,0,0,0,0,0,0,99573
23,8947,0,0,8947,0,1031,195,22,22,0,814,217,0,1031,5253,0,8947,7916,2,0,2,0,0,0,0,1,0,1,0,0,0,99531
24,98659,5693,0,104352,90623,8596,3174,784,785,1,4637,3958,7856,740,813,2142,8036,7296,1,0,1,0,2,0,0,1,1,0,0,1,0,99488
25,9471,0,0,9471,0,849,142,18,18,0,689,160,0,849,722,135,9471,8622,0,0,0,0,3,0,0,0,2,0,0,0,1,99445
26,13373,283,0,13656,4604,1170,229,47,47,0,894,276,339,831,4125,154,8769,7938,2,0,2,0,3,0,0,1,2,1,0,0,1,99396
27,92177,4824,0,97001,85074,6123,1660,512,516,4,3947,2172,5549,574,620,3051,7103,6529,3,1,3,0,5,1,0,3,3,1,0,1,1,99349
28,8123,54,0,8177,787,870,151,18,18,0,701,169,62,808,802,170,7336,6528,2,1,2,0,7,1,0,1,6,1,0,0,1,99300
29,14714,453,0,15167,8046,1223,286,61,61,0,876,347,579,644,3416,205,6668,6024,1,0,1,0,9,0,0,0,7,1,0,1,1,99243
30,10745,87981,0,98726,82551,3877,1404,473,478,5,1995,1877,3103,774,608,1661,5430,4656,5,0,5,0,10,0,0,5,7,0,0,1,2,99189
31,256,14936,0,15192,1612,5094,742,245,246,1,4106,987,3751,1343,600,175,13324,11981,1,2,1,0,14,2,0,0,12,1,0,0,2,99131
32,1581,19035,0,20616,10566,3275,450,77,78,1,2747,527,516,2759,973,253,8469,5710,1,0,1,0,14,0,0,0,12,1,0,0,2,99072
33,517,14270,0,14787,5495,2842,351,44,44,0,2447,395,666,2176,1767,1385,8775,6599,0,1,0,0,15,1,0,0,12,0,0,1,2,99007
34,89,6591,0,6680,719,2003,208,22,22,0,1773,230,182,1821,1178,804,5872,4051,1,0,1,0,14,0,0,0,12,1,0,0,2,98941
35,7036,72788,0,79824,67682,3389,1015,261,265,4,2109,1276,1971,1418,1005,413,5106,3688,4,0,4,0,15,0,0,2,12,2,0,1,2,98874
36,1189,21924,0,23113,11506,4043,596,269,273,4,3174,865,2571,1472,714,314,10418,8946,5,1,5,0,19,1,0,3,14,2,0,2,3,98802
37,1085,18523,0,19608,11020,2845,307,142,144,2,2394,449,664,2181,950,217,7503,5322,2,0,2,0,22,0,0,2,16,0,0,2,4,98728
38,262,9753,0,10015,2771,2182,213,65,67,2,1902,278,425,1757,1294,1065,6982,5225,4,0,4,0,22,0,0,4,17,0,0,0,5,98651
39,428,11532,0,11960,6883,1603,144,28,29,1,1430,172,185,1418,1018,665,4649,3231,2,0,2,0,25,0,0,2,20,0,0,0,5,98569
40,4329,64989,0,69318,60964,2343,448,282,288,6,1607,730,1216,1127,760,397,4025,2898,7,1,7,0,27,1,0,5,22,2,0,0,5,98482
41,812,16493,0,17305,9531,2707,351,164,166,2,2190,515,1575,1132,565,263,6962,5830,3,0,3,0,32,0,0,3,26,0,0,1,5,98391
42,1064,20229,0,21293,15239,2057,250,112,113,1,1694,362,480,1577,662,137,4990,3413,1,0,1,0,32,0,0,1,26,0,0,0,6,98297
43,405,10137,0,10542,5227,1670,157,76,77,1,1436,233,392,1278,845,556,4910,3632,4,0,4,0,32,0,0,2,26,2,0,0,6,98175
44,249,7147,0,7396,3644,1241,103,39,39,0,1099,142,181,1060,665,442,3503,2443,0,2,0,0,35,2,0,0,28,0,0,2,5,98067
45,3742,61839,0,65581,58782,1840,410,206,211,5,1219,616,947,893,558,273,3057,2164,6,0,6,0,29,0,0,4,24,2,0,0,5,97950
46,792,17435,0,18227,11619,2109,309,184,189,5,1611,493,1242,867,421,193,5816,4949,5,0,5,0,34,0,0,3,27,2,0,2,5,97824
47,616,15107,0,15723,11041,1552,172,102,105,3,1275,274,408,1144,496,144,4066,2922,3,5,3,0,39,5,0,3,30,0,0,2,7,97645
48,413,12875,0,13288,9207,1229,122,70,71,1,1036,192,265,964,603,481,3668,2704,2,6,2,0,34,6,0,1,27,1,0,0,7,97487
49,240,7734,0,7974,4938,934,84,33,33,0,817,117,151,783,494,406,2796,2013,1,0,1,0,33,0,0,0,26,1,0,1,6,97318
50,2173,51839,0,54012,49690,1104,129,91,93,2,882,220,467,637,398,248,2149,1512,3,1,3,0,25,1,0,2,21,1,0,0,4,97133
51,739,19231,0,19970,15510,1342,150,155,160,5,1032,305,726,616,306,155,3721,3105,5,0,5,0,24,0,0,5,20,0,0,1,3,96926
52,496,14518,0,15014,11732,1015,102,99,101,2,812,201,266,749,382,101,2786,2037,2,1,2,0,27,1,0,1,24,1,0,0,3,96688
53,275,8716,0,8991,6349,776,60,38,42,4,674,98,157,619,394,198,2367,1748,5,0,5,0,25,0,0,4,21,1,0,1,3,96424
54,300,8861,0,9161,7020,647,54,47,48,1,545,101,139,508,301,261,1841,1333,2,0,2,0,28,0,0,1,23,1,0,1,4,96132
55,1748,48205,0,49953,46656,801,76,90,91,1,634,166,337,464,247,161,1549,1085,2,0,2,0,26,0,0,1,20,1,0,1,5,95805
56,529,16285,0,16814,13424,949,113,139,145,6,691,252,502,447,176,104,2861,2414,7,1,7,0,24,1,0,4,18,1,2,0,6,95394
57,415,14134,0,14549,12174,705,59,74,77,3,569,133,216,489,259,80,1960,1471,4,1,4,0,29,1,0,3,21,1,0,2,6,94986
58,244,8328,0,8572,6604,582,30,47,50,3,502,77,138,444,261,135,1724,1280,5,0,5,0,32,0,0,5,23,0,0,1,8,94543
59,215,7327,0,7542,5930,499,32,36,38,2,429,68,98,401,214,211,1397,996,2,1,2,0,37,1,0,2,28,0,0,0,9,94047
60,1420,44970,0,46390,43805,612,55,88,89,1,468,143,257,355,175,113,1165,810,2,1,2,0,37,1,0,2,28,0,0,0,9,93509
61,482,15860,0,16342,13616,696,70,128,132,4,494,198,360,336,136,80,2244,1908,4,0,4,0,36,0,0,4,29,0,0,0,7,92934
62,409,13008,0,13417,11476,530,32,45,48,3,450,77,165,365,194,57,1532,1167,3,1,3,0,38,1,0,1,31,2,0,0,7,92293
63,190,7683,0,7873,6284,458,29,38,41,3,388,67,118,340,192,120,1399,1059,4,1,4,0,39,1,0,4,31,0,0,2,6,91563
64,182,6435,0,6617,5393,382,19,17,17,0,346,36,64,318,166,152,1042,724,2,2,2,0,41,2,0,1,34,1,0,0,7,90711
65,1193,41416,0,42609,40533,462,36,61,62,1,364,97,185,277,127,78,883,606,2,1,0,2,39,0,1,2,31,0,0,1,7,89759
66,391,15185,0,15576,13384,559,21,114,117,3,421,135,281,278,119,54,1801,1523,4,2,0,4,36,0,2,1,29,3,0,0,7,88680
67,306,11795,0,12101,10614,431,15,60,63,3,353,75,119,312,142,35,1181,869,5,4,0,5,32,0,4,4,27,1,0,2,3,87504
68,168,6846,0,7014,5803,352,12,29,31,2,309,41,77,275,149,76,1043,768,2,1,0,2,33,0,1,1,29,1,0,0,4,86267
69,163,5557,0,5720,4746,305,9,27,29,2,267,36,65,240,124,96,811,571,3,0,0,3,34,0,0,1,30,2,0,1,3,84993
70,1092,37122,0,38214,36423,388,15,56,58,2,315,71,167,221,104,57,699,478,2,1,0,2,37,0,1,2,31,0,0,2,4,83658
71,386,14327,0,14713,12747,463,16,114,118,4,329,130,232,231,87,45,1580,1349,6,2,0,6,31,0,2,4,28,2,0,0,3,82284
72,267,10694,0,10961,9655,371,14,63,66,3,291,77,96,275,128,29,1039,764,3,1,0,3,32,0,1,2,28,1,0,2,2,80829
73,171,6228,0,6399,5342,302,15,26,26,0,261,41,63,239,105,44,886,647,0,2,0,0,30,0,2,0,25,0,0,1,4,79303
74,110,4964,0,5074,4255,237,4,14,15,1,218,18,32,205,82,92,709,504,5,3,0,5,25,0,3,2,21,3,0,0,4,77667
75,1481,59964,0,61445,59385,379,12,58,61,3,306,70,182,197,84,55,579,382,3,5,0,3,24,0,5,2,18,1,0,3,3,75926
76,20,2618,0,2638,805,363,16,49,52,3,295,65,162,201,54,43,1813,1612,4,4,0,4,18,0,4,2,14,2,0,0,4,74098
77,24,1357,0,1381,785,221,5,7,7,0,209,12,3,218,128,16,572,354,0,2,0,0,20,0,2,0,15,0,0,2,3,72174
78,12,1088,0,1100,644,177,2,8,8,0,167,10,1,176,90,51,444,268,0,2,0,0,16,0,2,0,11,0,0,0,5,70155
79,7,837,0,844,536,155,1,1,1,0,153,2,4,151,57,51,301,150,0,2,0,0,14,0,2,0,10,0,0,0,4,68033
80,19,789,0,808,576,131,2,1,1,0,128,3,4,127,33,13,213,86,1,0,0,1,12,0,0,0,9,1,0,0,3,65833
81,12,718,0,730,537,110,0,0,0,0,110,0,4,106,29,6,181,75,0,0,0,0,12,0,0,0,9,0,0,1,2,63557
82,13,602,0,615,450,102,0,1,1,0,101,1,1,101,29,3,152,51,1,0,0,1,12,0,0,0,9,1,0,0,3,61142
83,7,557,0,564,418,97,1,0,0,0,96,1,1,96,20,4,139,43,1,1,0,1,10,0,1,0,8,1,0,0,2,58594
84,5,478,0,483,360,84,0,0,0,0,84,0,0,84,16,1,118,34,3,0,0,3,7,0,0,1,5,2,0,0,2,55905
85,6,429,0,435,322,79,2,0,0,0,77,2,0,79,20,0,107,28,4,3,0,4,8,0,3,1,4,1,2,2,2,53048
86,7,401,0,408,309,72,1,0,0,0,71,1,2,70,12,1,92,22,3,0,0,3,7,0,0,2,4,1,0,2,1,50041
87,6,344,0,350,260,69,0,1,1,0,68,1,3,66,8,0,84,18,2,0,0,2,10,0,0,0,6,2,0,1,3,46887
88,3,303,0,306,221,57,0,0,0,0,57,0,0,57,8,1,82,25,3,1,0,3,11,0,1,0,5,2,1,2,4,43705
89,3,248,0,251,178,56,0,0,0,0,56,0,0,56,12,0,70,14,2,1,0,2,12,0,1,0,4,2,0,2,6,40374
90,3,219,0,222,155,49,0,0,0,0,49,0,0,49,7,1,64,15,6,2,0,6,11,0,2,2,4,3,1,1,6,36941
91,3,215,0,218,157,50,0,0,0,0,50,0,1,49,8,0,58,9,4,1,0,4,15,0,1,0,5,3,1,4,6,33478
92,4,150,0,154,100,44,0,1,1,0,43,1,2,42,4,0,50,8,2,5,0,2,15,0,5,0,5,1,1,2,8,30013
93,1,134,0,135,92,36,0,0,0,0,36,0,0,36,5,0,42,6,3,1,0,3,12,0,1,0,3,3,0,2,7,26578
94,3,121,0,124,85,32,0,0,0,0,32,0,0,32,2,0,36,4,3,1,0,3,14,0,1,0,3,2,1,3,8,23267
95,1,88,0,89,58,25,0,0,0,0,25,0,1,24,1,0,30,6,5,3,0,5,14,0,3,3,3,0,2,3,8,20107
96,0,67,0,67,44,20,0,0,0,0,20,0,0,20,3,1,23,3,1,0,0,1,13,0,0,0,4,1,0,1,8,17191
97,0,59,0,59,39,16,0,0,0,0,16,0,0,16,1,0,20,4,2,0,0,2,13,0,0,0,4,1,1,1,8,14533
98,1,41,0,42,29,10,0,0,0,0,10,0,0,10,3,0,12,2,4,2,0,4,12,0,2,1,4,1,2,1,7,12113
99,1,29,0,30,18,9,0,0,0,0,9,0,0,9,0,0,11,2,1,2,0,1,12,0,2,1,4,0,0,2,6,0
100,0,0,0,0,0,0,0,0,0,0,0,0,0,0,0,0,0,0,0,0,0,0,0,0,0,0,0,0,0,0,0,0
