Age,Cyto,HPV,Cotest,Total test,Primary,Colpo,CIN2 detected,CIN3 detected,CIN3+ detected,Screening CC,fp,Precancer treatment,Screening colpo,Surveillance colpo,colpo3year,colpo1year,Repeat test,Normal test,Cancer,Cancer death,CancerInitialYoung,CancerInitialOld,CancerOngoing,CancerDeathYoung,CancerDeathOld,Stage1year1,Stage1year2+,Stage2-3year1,Stage4year1,Stage2+year2,Stage2+year3+,Population
1,0,0,0,0,0,0,0,0,0,0,0,0,0,0,0,0,0,0,0,0,0,0,0,0,0,0,0,0,0,0,0,0
2,0,0,0,0,0,0,0,0,0,0,0,0,0,0,0,0,0,0,0,0,0,0,0,0,0,0,0,0,0,0,0,0
3,0,0,0,0,0,0,0,0,0,0,0,0,0,0,0,0,0,0,0,0,0,0,0,0,0,0,0,0,0,0,0,0
4,0,0,0,0,0,0,0,0,0,0,0,0,0,0,0,0,0,0,0,0,0,0,0,0,0,0,0,0,0,0,0,0
5,0,0,0,0,0,0,0,0,0,0,0,0,0,0,0,0,0,0,0,0,0,0,0,0,0,0,0,0,0,0,0,0
6,0,0,0,0,0,0,0,0,0,0,0,0,0,0,0,0,0,0,0,0,0,0,0,0,0,0,0,0,0,0,0,0
7,0,0,0,0,0,0,0,0,0,0,0,0,0,0,0,0,0,0,0,0,0,0,0,0,0,0,0,0,0,0,0,0
8,0,0,0,0,0,0,0,0,0,0,0,0,0,0,0,0,0,0,0,0,0,0,0,0,0,0,0,0,0,0,0,0
9,0,0,0,0,0,0,0,0,0,0,0,0,0,0,0,0,0,0,0,0,0,0,0,0,0,0,0,0,0,0,0,99989
10,0,0,0,0,0,0,0,0,0,0,0,0,0,0,0,0,0,0,0,0,0,0,0,0,0,0,0,0,0,0,0,99978
11,0,0,0,0,0,0,0,0,0,0,0,0,0,0,0,0,0,0,0,0,0,0,0,0,0,0,0,0,0,0,0,99967
12,0,0,0,0,0,0,0,0,0,0,0,0,0,0,0,0,0,0,0,0,0,0,0,0,0,0,0,0,0,0,0,99953
13,0,0,0,0,0,0,0,0,0,0,0,0,0,0,0,0,0,0,0,0,0,0,0,0,0,0,0,0,0,0,0,99933
14,0,0,0,0,0,0,0,0,0,0,0,0,0,0,0,0,0,0,0,0,0,0,0,0,0,0,0,0,0,0,0,99907
15,0,0,0,0,0,0,0,0,0,0,0,0,0,0,0,0,0,0,0,0,0,0,0,0,0,0,0,0,0,0,0,99870
16,0,0,0,0,0,0,0,0,0,0,0,0,0,0,0,0,0,0,0,0,0,0,0,0,0,0,0,0,0,0,0,99828
17,0,0,0,0,0,0,0,0,0,0,0,0,0,0,0,0,0,0,0,0,0,0,0,0,0,0,0,0,0,0,0,99785
18,0,0,0,0,0,0,0,0,0,0,0,0,0,0,0,0,0,0,0,0,0,0,0,0,0,0,0,0,0,0,0,99742
19,0,0,0,0,0,0,0,0,0,0,0,0,0,0,0,0,0,0,0,0,0,0,0,0,0,0,0,0,0,0,0,99699
20,0,0,0,0,0,0,0,0,0,0,0,0,0,0,0,0,0,0,0,0,0,0,0,0,0,0,0,0,0,0,0,99657
21,102595,6816,0,109411,99596,9101,2532,487,487,0,6082,3019,8804,297,0,0,2999,2702,0,0,0,0,0,0,0,0,0,0,0,0,0,99615
22,8993,0,0,8993,0,1158,222,16,16,0,920,238,0,1158,0,0,8993,7835,0,0,0,0,0,0,0,0,0,0,0,0,0,99573
23,8973,0,0,8973,0,1009,211,16,17,1,781,227,0,1009,5226,0,8973,7964,2,0,2,0,0,0,0,1,0,1,0,0,0,99531
24,98571,5446,0,104017,90611,8359,3079,743,743,0,4537,3822,7639,720,794,2173,7960,7240,1,0,1,0,2,0,0,1,1,0,0,1,0,99488
25,9271,0,0,9271,0,892,131,15,15,0,746,146,0,892,689,163,9271,8379,0,0,0,0,3,0,0,0,2,0,0,0,1,99445
26,13172,254,0,13426,4591,1171,227,43,43,0,901,270,335,836,4014,179,8581,7745,1,0,1,0,3,0,0,1,2,0,0,0,1,99396
27,92360,4894,0,97254,85284,6369,1665,559,561,2,4143,2224,5743,626,667,2947,7076,6450,3,1,3,0,4,1,0,2,3,1,0,0,1,99349
28,8272,46,0,8318,766,860,144,17,17,0,699,161,65,795,795,141,7506,6711,2,0,2,0,6,0,0,1,5,1,0,0,1,99301
29,14834,446,0,15280,7962,1142,283,47,49,2,810,330,504,638,3606,201,6872,6234,3,1,3,0,8,1,0,2,6,1,0,1,1,99243
30,87980,87980,87980,175960,82491,5676,1499,473,478,5,3699,1972,4632,1044,623,1701,5489,4445,5,1,5,0,10,1,0,4,8,1,0,1,1,99188
31,16515,16515,16515,33030,1549,6039,789,266,268,2,4982,1055,4183,1856,533,154,14966,13110,2,0,2,0,14,0,0,2,12,0,0,0,2,99132
32,24915,24915,24915,49830,10726,5185,522,87,87,0,4576,609,1517,3668,2303,212,14189,10521,0,0,0,0,16,0,0,0,14,0,0,0,2,99073
33,19374,19374,19374,38748,5164,4555,461,58,59,1,4035,519,1355,3200,2172,1214,14210,11010,1,0,1,0,16,0,0,1,14,0,0,0,2,99009
34,9625,9625,9625,19250,448,3183,279,33,33,0,2871,312,333,2850,2185,724,9177,6327,0,0,0,0,17,0,0,0,15,0,0,0,2,98943
35,71175,71175,71175,142350,63412,5374,1025,250,254,4,4095,1275,3067,2307,1892,412,7763,5456,4,0,4,0,17,0,0,2,15,2,0,0,2,98876
36,19735,19735,19735,39470,7059,4980,548,217,219,2,4213,765,2614,2366,1253,334,12676,10310,2,1,2,0,21,1,0,2,17,0,0,2,2,98804
37,25205,25205,25205,50410,13497,4137,393,121,123,2,3621,514,1238,2899,2304,219,11708,8809,2,1,2,0,22,1,0,2,19,0,0,0,3,98729
38,16810,16810,16810,33620,5277,3475,257,104,104,0,3114,361,1022,2453,1951,886,11533,9080,1,0,1,0,21,0,0,0,20,1,0,0,1,98652
39,14975,14975,14975,29950,7431,2522,202,44,44,0,2276,246,465,2057,1781,495,7544,5487,0,0,0,0,21,0,0,0,19,0,0,1,1,98570
40,60261,60261,60261,120522,53857,3858,477,238,244,6,3137,715,2122,1736,1506,376,6404,4668,7,1,7,0,20,1,0,5,19,2,0,0,1,98483
41,12895,12895,12895,25790,4033,3182,275,103,106,3,2801,378,1470,1712,1031,276,8862,7150,4,1,4,0,25,1,0,3,23,1,0,1,1,98391
42,27107,27107,27107,54214,19119,3014,244,112,112,0,2658,356,1046,1968,1785,175,7988,6020,1,0,1,0,26,0,0,1,24,0,0,1,1,98297
43,16824,16824,16824,33648,8305,2780,239,97,98,1,2443,336,1033,1747,1246,464,8519,6772,2,1,2,0,26,1,0,1,24,1,0,0,2,98174
44,11688,11688,11688,23376,5701,2046,175,56,56,0,1815,231,478,1568,1315,272,5987,4419,2,0,2,0,24,0,0,2,22,0,0,1,1,98068
45,56051,56051,56051,112102,50524,3359,395,168,171,3,2793,563,1933,1426,1204,222,5527,4101,4,0,4,0,22,0,0,1,20,3,0,0,2,97951
46,12055,12055,12055,24110,4368,2659,250,148,152,4,2257,398,1214,1445,762,227,7687,6242,4,1,4,0,23,1,0,4,19,0,0,2,2,97824
47,23103,23103,23103,46206,16302,2298,175,88,90,2,2033,263,773,1525,1589,176,6801,5276,2,0,2,0,26,0,0,1,23,1,0,0,3,97650
48,20188,20188,20188,40376,13185,2188,152,93,97,4,1939,245,881,1307,1052,379,7003,5696,4,1,4,0,27,1,0,2,23,1,1,1,3,97497
49,11123,11123,11123,22246,6241,1596,107,56,57,1,1432,163,391,1205,1026,296,4882,3677,1,1,1,0,29,1,0,1,24,0,0,2,3,97327
50,46003,46003,46003,92006,41682,2261,131,94,98,4,2032,225,1255,1006,984,201,4321,3315,4,1,4,0,27,1,0,3,23,1,0,0,4,97142
51,13634,13634,13634,27268,7981,1826,152,132,132,0,1542,284,847,979,679,156,5653,4674,0,3,0,0,27,3,0,0,22,0,0,1,4,96932
52,21196,21196,21196,42392,16235,1685,106,64,64,0,1515,170,643,1042,1251,113,4961,3919,0,1,0,0,22,1,0,0,17,0,0,0,5,96694
53,17278,17278,17278,34556,11949,1499,79,69,73,4,1347,148,624,875,763,178,5329,4454,6,0,6,0,20,0,0,5,17,1,0,0,3,96430
54,12643,12643,12643,25286,8795,1207,71,50,51,1,1085,121,419,788,823,181,3848,3060,1,3,1,0,25,3,0,0,21,1,0,1,3,96135
55,40488,40488,40488,80976,36911,1743,93,82,87,5,1563,175,1032,711,733,121,3577,2866,6,1,6,0,19,1,0,5,15,1,0,1,3,95807
56,11071,11071,11071,22142,6531,1350,88,123,126,3,1136,211,642,708,559,115,4540,3832,2,0,2,0,23,0,0,2,18,0,0,1,4,95397
57,20879,20879,20879,41758,16911,1336,56,56,58,2,1222,112,595,741,992,77,3968,3227,2,0,2,0,23,0,0,2,18,0,0,0,5,94990
58,16614,16614,16614,33228,12133,1267,48,88,90,2,1129,136,617,650,576,127,4481,3831,3,0,3,0,22,0,0,2,19,1,0,0,3,94547
59,11539,11539,11539,23078,8309,980,37,44,46,2,897,81,352,628,734,149,3230,2602,5,0,5,0,23,0,0,2,19,2,1,1,3,94052
60,36858,36858,36858,73716,33712,1509,56,93,96,3,1357,149,946,563,649,78,3146,2583,3,1,3,0,26,1,0,2,20,1,0,2,4,93514
61,10317,10317,10317,20634,6516,1032,58,88,90,2,884,146,478,554,472,98,3801,3247,3,0,3,0,27,0,0,3,20,0,0,1,6,92939
62,19581,19581,19581,39162,16291,1069,46,47,49,2,974,93,545,524,903,59,3290,2766,2,2,2,0,27,2,0,1,20,1,0,0,7,92297
63,15924,15924,15924,31848,12213,1004,44,50,55,5,905,94,506,498,477,95,3711,3213,5,1,5,0,26,1,0,3,20,2,0,1,5,91567
64,10671,10671,10671,21342,7989,768,24,32,34,2,710,56,311,457,580,114,2682,2225,4,1,4,0,30,1,0,4,22,0,0,2,6,90716
65,33046,33046,33046,66092,30452,1253,30,67,70,3,1153,97,803,450,529,67,2594,2144,3,1,0,3,32,0,1,3,25,0,0,0,7,89764
66,9619,9619,9619,19238,6418,844,23,86,86,0,735,109,396,448,371,82,3201,2753,0,3,0,0,32,0,3,0,27,0,0,0,5,88684
67,18194,18194,18194,36388,15353,902,15,43,45,2,842,58,458,444,782,31,2841,2397,3,1,0,3,30,0,1,3,27,0,0,0,3,87511
68,15027,15027,15027,30054,11874,888,19,56,58,2,811,75,446,442,385,62,3153,2711,3,0,0,3,30,0,0,2,28,1,0,0,2,86275
69,9756,9756,9756,19512,7417,709,17,32,34,2,658,49,289,420,492,65,2339,1919,2,1,0,2,32,0,1,1,30,1,0,1,1,85000
70,29137,29137,29137,58274,26745,1107,14,60,63,3,1030,74,714,393,467,48,2392,1999,4,2,0,4,26,0,2,2,24,2,0,1,1,83664
71,8892,8892,8892,17784,6023,749,17,74,76,2,656,91,332,417,352,42,2869,2452,2,0,0,2,27,0,0,1,25,1,0,0,2,82292
72,16616,16616,16616,33232,14129,784,13,54,56,2,715,67,397,387,678,39,2487,2100,4,1,0,4,29,0,1,2,26,2,0,1,2,80836
73,14001,14001,14001,28002,11209,748,10,41,42,1,696,51,390,358,364,47,2792,2434,1,2,0,1,29,0,2,1,26,0,0,2,1,79310
74,8893,8893,8893,17786,6853,592,10,35,35,0,547,45,243,349,415,68,2040,1691,1,3,0,1,24,0,3,1,23,0,0,0,1,77674
75,59879,59879,59879,119758,57837,1541,15,49,53,4,1473,64,1234,307,409,43,2042,1735,4,5,0,4,20,0,5,4,19,0,0,0,1,75933
76,4354,4354,4354,8708,632,653,13,42,45,3,595,55,248,405,309,33,3722,3317,3,4,0,3,17,0,4,1,16,2,0,0,1,74105
77,3715,3715,3715,7430,609,507,6,8,8,0,493,14,146,361,1086,24,3106,2745,0,1,0,0,18,0,1,0,15,0,0,2,1,72182
78,3645,3645,3645,7290,510,461,4,6,6,0,451,10,182,279,331,39,3135,2856,0,1,0,0,14,0,1,0,11,0,0,0,3,70163
79,1278,1278,1278,2556,456,264,6,2,2,0,256,8,12,252,279,38,822,570,2,1,0,2,11,0,1,1,9,1,0,0,2,68042
80,1029,1029,1029,2058,463,201,1,0,0,0,200,1,14,187,236,10,566,379,0,0,0,0,11,0,0,0,9,0,0,0,2,65842
81,786,786,786,1572,429,177,5,3,3,0,169,8,14,163,99,9,357,194,1,1,0,1,11,0,1,0,9,1,0,0,2,63565
82,649,649,649,1298,371,148,2,0,0,0,146,2,7,141,63,6,278,137,1,0,0,1,10,0,0,1,8,0,0,0,2,61150
83,556,556,556,1112,343,128,1,0,0,0,127,1,7,121,42,1,213,92,1,0,0,1,11,0,0,0,9,1,0,0,2,58603
84,494,494,494,988,302,119,0,0,0,0,119,0,6,113,31,5,192,79,0,1,0,0,10,0,1,0,7,0,0,1,2,55913
85,443,443,443,886,273,111,0,0,0,0,111,0,7,104,22,2,170,66,2,0,0,2,9,0,0,1,7,1,0,0,2,53059
86,401,401,401,802,239,105,0,2,2,0,103,2,7,98,24,1,162,64,2,0,0,2,10,0,0,0,7,2,0,1,2,50051
87,374,374,374,748,228,88,0,0,0,0,88,0,6,82,20,0,146,64,4,1,0,4,9,0,1,0,6,2,2,1,2,46893
88,305,305,305,610,187,79,0,0,0,0,79,0,7,72,21,0,118,46,3,1,0,3,10,0,1,2,5,1,0,2,3,43710
89,247,247,247,494,138,73,0,0,0,0,73,0,2,71,19,0,109,38,3,1,0,3,11,0,1,0,7,3,0,1,3,40379
90,237,237,237,474,149,60,0,0,0,0,60,0,6,54,12,0,88,34,3,2,0,3,11,0,2,0,4,2,1,3,4,36945
91,191,191,191,382,117,53,1,0,0,0,52,1,1,52,11,0,74,22,4,1,0,4,10,0,1,2,3,1,1,2,5,33482
92,146,146,146,292,82,48,0,0,0,0,48,0,4,44,6,0,64,20,2,1,0,2,10,0,1,0,4,2,0,1,5,30021
93,155,155,155,310,94,40,0,0,0,0,40,0,3,37,6,0,61,24,1,1,0,1,8,0,1,0,4,0,1,0,4,26585
94,128,128,128,256,73,39,0,0,0,0,39,0,1,38,10,0,55,17,1,2,0,1,6,0,2,0,4,1,0,0,2,23273
95,90,90,90,180,48,35,0,0,0,0,35,0,2,33,3,0,42,9,2,1,0,2,6,0,1,0,4,2,0,0,2,20114
96,84,84,84,168,49,27,0,0,0,0,27,0,2,25,3,0,35,10,4,1,0,4,6,0,1,1,4,2,1,1,1,17197
97,72,72,72,144,40,22,0,0,0,0,22,0,1,21,5,0,32,11,2,1,0,2,8,0,1,1,4,1,0,2,2,14535
98,43,43,43,86,21,18,0,0,0,0,18,0,1,17,2,0,22,5,2,0,0,2,9,0,0,1,5,1,0,1,3,12115
99,39,39,39,78,15,17,0,0,0,0,17,0,1,16,3,0,24,8,3,0,0,3,10,0,0,0,6,2,1,0,4,0
100,0,0,0,0,0,0,0,0,0,0,0,0,0,0,0,0,0,0,0,0,0,0,0,0,0,0,0,0,0,0,0,0
