Age,Cyto,HPV,Cotest,Total test,Primary,Colpo,CIN2 detected,CIN3 detected,CIN3+ detected,Screening CC,fp,Precancer treatment,Screening colpo,Surveillance colpo,colpo3year,colpo1year,Repeat test,Normal test,Cancer,Cancer death,CancerInitialYoung,CancerInitialOld,CancerOngoing,CancerDeathYoung,CancerDeathOld,Stage1year1,Stage1year2+,Stage2-3year1,Stage4year1,Stage2+year2,Stage2+year3+,Population
1,0,0,0,0,0,0,0,0,0,0,0,0,0,0,0,0,0,0,0,0,0,0,0,0,0,0,0,0,0,0,0,0
2,0,0,0,0,0,0,0,0,0,0,0,0,0,0,0,0,0,0,0,0,0,0,0,0,0,0,0,0,0,0,0,0
3,0,0,0,0,0,0,0,0,0,0,0,0,0,0,0,0,0,0,0,0,0,0,0,0,0,0,0,0,0,0,0,0
4,0,0,0,0,0,0,0,0,0,0,0,0,0,0,0,0,0,0,0,0,0,0,0,0,0,0,0,0,0,0,0,0
5,0,0,0,0,0,0,0,0,0,0,0,0,0,0,0,0,0,0,0,0,0,0,0,0,0,0,0,0,0,0,0,0
6,0,0,0,0,0,0,0,0,0,0,0,0,0,0,0,0,0,0,0,0,0,0,0,0,0,0,0,0,0,0,0,0
7,0,0,0,0,0,0,0,0,0,0,0,0,0,0,0,0,0,0,0,0,0,0,0,0,0,0,0,0,0,0,0,0
8,0,0,0,0,0,0,0,0,0,0,0,0,0,0,0,0,0,0,0,0,0,0,0,0,0,0,0,0,0,0,0,0
9,0,0,0,0,0,0,0,0,0,0,0,0,0,0,0,0,0,0,0,0,0,0,0,0,0,0,0,0,0,0,0,99989
10,0,0,0,0,0,0,0,0,0,0,0,0,0,0,0,0,0,0,0,0,0,0,0,0,0,0,0,0,0,0,0,99978
11,0,0,0,0,0,0,0,0,0,0,0,0,0,0,0,0,0,0,0,0,0,0,0,0,0,0,0,0,0,0,0,99967
12,0,0,0,0,0,0,0,0,0,0,0,0,0,0,0,0,0,0,0,0,0,0,0,0,0,0,0,0,0,0,0,99953
13,0,0,0,0,0,0,0,0,0,0,0,0,0,0,0,0,0,0,0,0,0,0,0,0,0,0,0,0,0,0,0,99933
14,0,0,0,0,0,0,0,0,0,0,0,0,0,0,0,0,0,0,0,0,0,0,0,0,0,0,0,0,0,0,0,99907
15,0,0,0,0,0,0,0,0,0,0,0,0,0,0,0,0,0,0,0,0,0,0,0,0,0,0,0,0,0,0,0,99870
16,0,0,0,0,0,0,0,0,0,0,0,0,0,0,0,0,0,0,0,0,0,0,0,0,0,0,0,0,0,0,0,99828
17,0,0,0,0,0,0,0,0,0,0,0,0,0,0,0,0,0,0,0,0,0,0,0,0,0,0,0,0,0,0,0,99785
18,0,0,0,0,0,0,0,0,0,0,0,0,0,0,0,0,0,0,0,0,0,0,0,0,0,0,0,0,0,0,0,99742
19,0,0,0,0,0,0,0,0,0,0,0,0,0,0,0,0,0,0,0,0,0,0,0,0,0,0,0,0,0,0,0,99699
20,0,0,0,0,0,0,0,0,0,0,0,0,0,0,0,0,0,0,0,0,0,0,0,0,0,0,0,0,0,0,0,99657
21,102565,6660,0,109225,99596,9059,2485,502,502,0,6072,2987,8747,312,0,0,2969,2657,0,0,0,0,0,0,0,0,0,0,0,0,0,99615
22,8934,0,0,8934,0,1120,217,21,21,0,882,238,0,1120,0,0,8934,7814,0,0,0,0,0,0,0,0,0,0,0,0,0,99573
23,8897,0,0,8897,0,1061,205,21,22,1,834,226,0,1061,5252,0,8897,7836,2,0,2,0,0,0,0,1,0,1,0,0,0,99531
24,98633,5580,0,104213,90669,8529,3113,757,758,1,4658,3870,7842,687,762,2135,7964,7277,1,0,1,0,2,0,0,1,1,0,0,1,0,99488
25,9453,0,0,9453,0,903,122,16,16,0,765,138,0,903,735,157,9453,8550,1,0,1,0,3,0,0,1,2,0,0,0,1,99445
26,13291,278,0,13569,4556,1126,214,39,40,1,872,253,337,789,4137,153,8735,7946,1,0,1,0,4,0,0,1,3,0,0,0,1,99396
27,92280,4743,0,97023,85117,6238,1719,559,563,4,3956,2278,5691,547,683,3026,7163,6616,5,0,5,0,5,0,0,4,4,1,0,0,1,99350
28,8182,47,0,8229,800,834,165,21,21,0,648,186,60,774,784,129,7382,6608,0,1,0,0,9,1,0,0,8,0,0,0,1,99301
29,14826,445,0,15271,8050,1170,285,58,58,0,827,343,542,628,3476,200,6776,6148,2,0,2,0,9,0,0,1,8,1,0,0,1,99244
30,87987,87987,87987,175974,82479,5526,1479,449,453,4,3594,1928,4488,1038,587,1748,5508,4470,4,0,4,0,11,0,0,4,9,0,0,1,1,99190
31,16422,16422,16422,32844,1563,5987,826,232,236,4,4925,1058,4149,1838,572,162,14859,13021,4,1,4,0,14,1,0,3,13,1,0,0,1,99133
32,24641,24641,24641,49282,10648,5022,466,88,89,1,4467,554,1457,3565,2271,246,13993,10428,1,0,1,0,18,0,0,1,16,0,0,1,1,99074
33,19179,19179,19179,38358,5191,4626,469,80,80,0,4077,549,1414,3212,2163,1162,13988,10776,0,0,0,0,19,0,0,0,17,0,0,0,2,99010
34,9477,9477,9477,18954,428,3226,241,17,18,1,2967,258,361,2865,2111,703,9049,6184,1,0,1,0,19,0,0,1,17,0,0,0,2,98944
35,71396,71396,71396,142792,63568,5363,1051,252,258,6,4054,1303,2997,2366,1908,389,7828,5462,6,1,6,0,20,1,0,5,18,1,0,0,2,98876
36,19768,19768,19768,39536,7085,4890,560,205,205,0,4125,765,2565,2325,1239,335,12683,10358,0,0,0,0,24,0,0,0,22,0,0,0,2,98805
37,25063,25063,25063,50126,13456,4124,377,121,122,1,3625,498,1227,2897,2241,197,11607,8710,1,0,1,0,23,0,0,1,21,0,0,0,2,98731
38,16562,16562,16562,33124,5232,3526,290,106,110,4,3126,396,1008,2518,1851,883,11330,8812,6,0,6,0,22,0,0,3,21,3,0,0,1,98654
39,14829,14829,14829,29658,7347,2611,213,38,38,0,2360,251,534,2077,1744,545,7482,5405,2,1,2,0,27,1,0,1,23,1,0,3,1,98571
40,60614,60614,60614,121228,54082,3898,474,228,229,1,3195,702,2155,1743,1521,347,6532,4789,1,0,1,0,27,0,0,1,23,0,0,1,3,98485
41,13099,13099,13099,26198,4123,3246,291,130,133,3,2822,421,1426,1820,1081,303,8976,7156,3,1,3,0,27,1,0,2,24,1,0,0,3,98393
42,27260,27260,27260,54520,19216,3094,279,111,114,3,2701,390,1072,2022,1756,170,8044,6022,5,0,5,0,26,0,0,5,22,0,0,1,3,98299
43,16553,16553,16553,33106,7956,2774,224,68,68,0,2482,292,1003,1771,1260,484,8597,6826,1,1,1,0,31,1,0,1,27,0,0,0,4,98176
44,11586,11586,11586,23172,5555,2088,179,58,59,1,1850,237,510,1578,1354,273,6031,4453,2,0,2,0,30,0,0,1,27,1,0,0,3,98070
45,56455,56455,56455,112910,50881,3332,378,181,187,6,2767,559,1935,1397,1254,216,5574,4177,8,2,8,0,27,2,0,7,24,1,0,0,3,97951
46,12168,12168,12168,24336,4370,2643,265,132,133,1,2245,397,1249,1394,846,236,7798,6404,1,0,1,0,30,0,0,1,28,0,0,0,2,97825
47,23266,23266,23266,46532,16354,2416,195,114,117,3,2104,309,814,1602,1646,148,6912,5310,3,1,3,0,31,1,0,3,29,0,0,0,2,97650
48,19863,19863,19863,39726,12931,2145,156,91,92,1,1897,247,818,1327,997,360,6932,5605,1,3,1,0,30,3,0,1,28,0,0,0,2,97495
49,10935,10935,10935,21870,6047,1593,103,55,56,1,1434,158,426,1167,1066,274,4888,3721,2,1,2,0,28,1,0,0,26,2,0,0,2,97325
50,46420,46420,46420,92840,42094,2265,153,91,95,4,2017,244,1293,972,987,213,4326,3354,4,1,4,0,23,1,0,3,19,1,0,2,2,97140
51,13494,13494,13494,26988,8011,1774,128,114,115,1,1531,242,790,984,672,184,5483,4499,1,2,1,0,26,2,0,1,21,0,0,1,4,96931
52,21152,21152,21152,42304,16369,1681,92,66,69,3,1520,158,677,1004,1224,118,4783,3779,3,0,3,0,24,0,0,3,20,0,0,0,4,96694
53,16949,16949,16949,33898,11641,1597,99,85,88,3,1410,184,686,911,754,175,5308,4397,3,2,3,0,21,2,0,3,20,0,0,0,1,96428
54,12493,12493,12493,24986,8635,1201,72,61,63,2,1066,133,402,799,831,167,3858,3059,3,1,3,0,22,1,0,3,21,0,0,0,1,96135
55,40996,40996,40996,81992,37418,1811,96,82,86,4,1629,178,1067,744,796,106,3578,2834,5,0,5,0,23,0,0,3,23,2,0,0,0,95808
56,11096,11096,11096,22192,6588,1298,93,119,121,2,1084,212,580,718,518,112,4508,3790,2,1,2,0,27,1,0,1,25,1,0,2,0,95397
57,20877,20877,20877,41754,16927,1338,54,52,55,3,1229,106,601,737,1059,93,3950,3213,3,0,3,0,23,0,0,3,21,0,0,1,1,94990
58,16226,16226,16226,32452,11794,1269,63,75,79,4,1127,138,607,662,550,116,4432,3770,4,0,4,0,25,0,0,4,23,0,0,0,2,94547
59,11350,11350,11350,22700,8151,986,42,58,58,0,886,100,381,605,715,150,3199,2594,0,1,0,0,27,1,0,0,25,0,0,0,2,94051
60,37204,37204,37204,74408,34202,1461,54,67,72,5,1335,121,884,577,649,62,3002,2425,7,1,7,0,21,1,0,5,20,2,0,0,1,93513
61,10325,10325,10325,20650,6550,975,59,87,90,3,826,146,438,537,445,103,3775,3238,4,0,4,0,27,0,0,1,24,2,1,2,1,92938
62,19680,19680,19680,39360,16373,1085,35,49,51,2,999,84,541,544,907,66,3307,2763,2,2,2,0,29,2,0,1,23,1,0,3,3,92296
63,15622,15622,15622,31244,11883,965,49,49,52,3,864,98,496,469,456,83,3739,3270,3,1,3,0,31,1,0,2,24,1,0,1,6,91566
64,10485,10485,10485,20970,7790,745,28,43,45,2,672,71,293,452,629,90,2695,2243,2,1,2,0,33,1,0,1,25,1,0,1,7,90715
65,70901,70901,70901,141802,68382,2007,43,78,81,3,1883,121,1589,418,509,57,2519,2101,4,0,0,4,33,0,0,3,25,0,1,1,7,89764
66,6067,6067,6067,12134,1267,943,29,100,102,2,812,129,448,495,357,77,4800,4305,2,4,0,2,32,0,4,0,27,2,0,0,5,88683
67,5380,5380,5380,10760,1236,729,14,21,21,0,694,35,181,548,1427,58,4144,3596,1,2,0,1,31,0,2,1,24,0,0,2,5,87509
68,5026,5026,5026,10052,1004,660,12,15,15,0,633,27,235,425,440,85,4022,3597,0,0,0,0,27,0,0,0,22,0,0,0,5,86273
69,2251,2251,2251,4502,999,389,3,13,13,0,373,16,34,355,369,87,1252,897,3,3,0,3,24,0,3,1,20,2,0,0,4,84996
70,1910,1910,1910,3820,1026,316,4,3,3,0,309,7,33,283,330,34,884,601,1,1,0,1,23,0,1,0,20,1,0,0,3,83661
71,1427,1427,1427,2854,861,255,4,3,3,0,248,7,27,228,144,21,566,338,5,0,0,5,22,0,0,3,19,2,0,1,2,82289
72,1335,1335,1335,2670,892,227,9,2,2,0,216,11,31,196,115,12,443,247,6,1,0,6,23,0,1,1,19,3,2,2,2,80833
73,1147,1147,1147,2294,763,200,1,5,5,0,194,6,26,174,78,7,384,210,4,2,0,4,24,0,2,2,16,2,0,4,4,79307
74,1032,1032,1032,2064,677,160,4,0,0,0,156,4,12,148,66,5,355,207,5,0,0,5,26,0,0,1,17,2,2,2,7,77674
75,994,994,994,1988,695,160,0,1,1,0,159,1,19,141,66,4,299,158,7,9,0,7,24,0,9,2,14,5,0,2,8,75929
76,837,837,837,1674,570,145,0,2,2,0,143,2,18,127,32,5,267,140,9,7,0,9,19,0,7,0,9,7,2,4,6,74098
77,798,798,798,1596,555,124,0,1,1,0,123,1,12,112,46,3,243,131,8,6,0,8,22,0,6,3,7,2,3,8,7,72170
78,670,670,670,1340,465,125,0,2,2,0,123,2,17,108,44,2,205,97,10,3,0,10,25,0,3,2,9,6,2,4,12,70150
79,589,589,589,1178,412,120,0,0,0,0,120,0,18,102,30,1,177,75,6,2,0,6,28,0,2,1,10,4,1,5,13,68028
80,571,571,571,1142,383,108,0,1,1,0,107,1,10,98,28,1,188,90,5,3,0,5,32,0,3,2,11,3,0,5,16,65825
81,509,509,509,1018,338,103,0,1,1,0,102,1,9,94,32,0,171,77,3,3,0,3,31,0,3,0,11,1,2,3,17,63546
82,453,453,453,906,305,91,0,0,0,0,91,0,11,80,24,0,148,68,7,1,0,7,32,0,1,2,11,3,2,2,19,61131
83,409,409,409,818,271,86,1,0,0,0,85,1,9,77,25,0,138,61,9,6,0,9,36,0,6,2,13,5,2,4,19,58578
84,356,356,356,712,229,84,0,1,1,0,83,1,7,77,23,1,127,50,3,3,0,3,40,0,3,0,14,2,1,5,21,55886
85,338,338,338,676,220,71,1,0,0,0,70,1,2,69,15,0,118,49,5,3,0,5,36,0,3,0,13,4,1,2,21,53030
86,285,285,285,570,182,71,0,0,0,0,71,0,4,67,13,0,103,36,7,5,0,7,34,0,5,2,11,4,1,3,20,50018
87,242,242,242,484,145,67,0,1,1,0,66,1,4,63,8,0,97,34,5,2,0,5,34,0,2,2,11,2,1,3,20,46863
88,225,225,225,450,136,63,0,0,0,0,63,0,4,59,9,1,89,30,1,1,0,1,34,0,1,1,10,0,0,2,22,43682
89,185,185,185,370,104,54,0,0,0,0,54,0,1,53,8,0,81,28,2,1,0,2,31,0,1,0,9,2,1,0,22,40351
90,169,169,169,338,102,52,0,0,0,0,52,0,2,50,9,0,67,17,2,2,0,2,26,0,2,2,8,0,0,1,17,36919
91,132,132,132,264,71,47,0,0,0,0,47,0,2,45,7,1,61,16,3,0,0,3,22,0,0,0,6,3,0,0,16,33461
92,116,116,116,232,61,38,0,0,0,0,38,0,2,36,6,0,55,19,2,0,0,2,22,0,0,0,6,1,1,3,13,30003
93,93,93,93,186,46,36,1,0,0,0,35,1,1,35,6,0,47,12,2,2,0,2,18,0,2,0,5,1,1,2,11,26570
94,63,63,63,126,24,35,0,0,0,0,35,0,1,34,3,0,39,5,4,3,0,4,14,0,3,2,4,1,1,2,8,23260
95,56,56,56,112,21,32,0,0,0,0,32,0,2,30,0,0,35,5,3,1,0,3,9,0,1,0,1,4,0,1,7,20103
96,46,46,46,92,17,22,0,1,1,0,21,1,0,22,4,0,29,7,0,0,0,0,7,0,0,0,1,0,0,2,4,17190
97,33,33,33,66,10,20,0,0,0,0,20,0,0,20,4,0,23,3,2,0,0,2,4,0,0,1,0,0,1,0,4,14532
98,23,23,23,46,2,18,0,0,0,0,18,0,1,17,0,0,21,4,2,2,0,2,4,0,2,0,1,2,0,1,2,12112
99,21,21,21,42,4,13,0,0,0,0,13,0,1,12,1,0,17,5,2,2,0,2,4,0,2,1,1,0,2,1,2,0
100,0,0,0,0,0,0,0,0,0,0,0,0,0,0,0,0,0,0,0,0,0,0,0,0,0,0,0,0,0,0,0,0
