Age,Cyto,HPV,Cotest,Total test,Primary,Colpo,CIN2 detected,CIN3 detected,CIN3+ detected,Screening CC,fp,Precancer treatment,Screening colpo,Surveillance colpo,colpo3year,colpo1year,Repeat test,Normal test,Cancer,Cancer death,CancerInitialYoung,CancerInitialOld,CancerOngoing,CancerDeathYoung,CancerDeathOld,Stage1year1,Stage1year2+,Stage2-3year1,Stage4year1,Stage2+year2,Stage2+year3+,Population
1,0,0,0,0,0,0,0,0,0,0,0,0,0,0,0,0,0,0,0,0,0,0,0,0,0,0,0,0,0,0,0,0
2,0,0,0,0,0,0,0,0,0,0,0,0,0,0,0,0,0,0,0,0,0,0,0,0,0,0,0,0,0,0,0,0
3,0,0,0,0,0,0,0,0,0,0,0,0,0,0,0,0,0,0,0,0,0,0,0,0,0,0,0,0,0,0,0,0
4,0,0,0,0,0,0,0,0,0,0,0,0,0,0,0,0,0,0,0,0,0,0,0,0,0,0,0,0,0,0,0,0
5,0,0,0,0,0,0,0,0,0,0,0,0,0,0,0,0,0,0,0,0,0,0,0,0,0,0,0,0,0,0,0,0
6,0,0,0,0,0,0,0,0,0,0,0,0,0,0,0,0,0,0,0,0,0,0,0,0,0,0,0,0,0,0,0,0
7,0,0,0,0,0,0,0,0,0,0,0,0,0,0,0,0,0,0,0,0,0,0,0,0,0,0,0,0,0,0,0,0
8,0,0,0,0,0,0,0,0,0,0,0,0,0,0,0,0,0,0,0,0,0,0,0,0,0,0,0,0,0,0,0,0
9,0,0,0,0,0,0,0,0,0,0,0,0,0,0,0,0,0,0,0,0,0,0,0,0,0,0,0,0,0,0,0,99989
10,0,0,0,0,0,0,0,0,0,0,0,0,0,0,0,0,0,0,0,0,0,0,0,0,0,0,0,0,0,0,0,99978
11,0,0,0,0,0,0,0,0,0,0,0,0,0,0,0,0,0,0,0,0,0,0,0,0,0,0,0,0,0,0,0,99967
12,0,0,0,0,0,0,0,0,0,0,0,0,0,0,0,0,0,0,0,0,0,0,0,0,0,0,0,0,0,0,0,99953
13,0,0,0,0,0,0,0,0,0,0,0,0,0,0,0,0,0,0,0,0,0,0,0,0,0,0,0,0,0,0,0,99933
14,0,0,0,0,0,0,0,0,0,0,0,0,0,0,0,0,0,0,0,0,0,0,0,0,0,0,0,0,0,0,0,99907
15,0,0,0,0,0,0,0,0,0,0,0,0,0,0,0,0,0,0,0,0,0,0,0,0,0,0,0,0,0,0,0,99870
16,0,0,0,0,0,0,0,0,0,0,0,0,0,0,0,0,0,0,0,0,0,0,0,0,0,0,0,0,0,0,0,99828
17,0,0,0,0,0,0,0,0,0,0,0,0,0,0,0,0,0,0,0,0,0,0,0,0,0,0,0,0,0,0,0,99785
18,0,0,0,0,0,0,0,0,0,0,0,0,0,0,0,0,0,0,0,0,0,0,0,0,0,0,0,0,0,0,0,99742
19,0,0,0,0,0,0,0,0,0,0,0,0,0,0,0,0,0,0,0,0,0,0,0,0,0,0,0,0,0,0,0,99699
20,0,0,0,0,0,0,0,0,0,0,0,0,0,0,0,0,0,0,0,0,0,0,0,0,0,0,0,0,0,0,0,99657
21,102689,6850,0,109539,99596,9128,2607,502,502,0,6019,3109,8838,290,0,0,3093,2803,0,0,0,0,0,0,0,0,0,0,0,0,0,99615
22,101851,6031,0,107882,90698,8866,2098,271,272,1,6496,2369,7534,1332,0,0,11153,9821,1,0,1,0,0,0,0,1,0,0,0,0,0,99573
23,101646,5321,0,106967,83107,8429,2056,212,212,0,6161,2268,6307,2122,5162,0,18539,16417,0,0,0,0,1,0,0,0,1,0,0,0,0,99531
24,101124,4523,0,105647,81241,6977,1602,205,206,1,5169,1807,4927,2050,5644,2296,19883,17833,1,0,1,0,1,0,0,1,1,0,0,0,0,99488
25,98481,4199,0,102680,81275,5717,1135,173,173,0,4409,1308,4058,1659,5391,1739,17206,15547,0,0,0,0,2,0,0,0,2,0,0,0,0,99445
26,96375,4288,0,100663,81922,5444,851,110,111,1,4482,961,4069,1375,4599,1727,14453,13078,1,0,1,0,2,0,0,0,2,1,0,0,0,99396
27,96730,4563,0,101293,83935,5645,894,104,105,1,4646,998,4346,1299,3933,1411,12795,11496,1,0,1,0,3,0,0,1,2,0,0,1,0,99350
28,95003,4382,0,99385,82579,5455,966,130,130,0,4359,1096,4198,1257,3940,1044,12424,11167,0,0,0,0,4,0,0,0,3,0,0,0,1,99302
29,93935,4147,0,98082,81860,5154,932,114,114,0,4108,1046,3974,1180,4077,747,12075,10895,0,0,0,0,4,0,0,0,3,0,0,0,1,99245
30,94699,4164,0,98863,83162,4933,849,114,114,0,3970,963,3784,1149,3851,768,11537,10388,0,0,0,0,4,0,0,0,3,0,0,0,1,99191
31,92976,4264,0,97240,81920,4796,724,80,81,1,3991,804,3714,1082,3623,854,11056,9974,1,0,1,0,4,0,0,1,3,0,0,0,1,99135
32,91628,4189,0,95817,80982,4826,685,92,92,0,4049,777,3797,1029,3504,841,10646,9617,0,0,0,0,5,0,0,0,4,0,0,0,1,99076
33,92365,4039,0,96404,81780,4698,819,105,106,1,3773,924,3681,1017,3531,702,10585,9568,1,0,1,0,5,0,0,0,4,1,0,0,1,99012
34,90712,3862,0,94574,80453,4407,673,90,90,0,3644,763,3439,968,3584,680,10259,9291,1,1,1,0,5,1,0,1,4,0,0,0,1,98945
35,89510,3970,0,93480,79738,4279,627,98,98,0,3554,725,3306,973,3347,568,9772,8799,0,0,0,0,6,0,0,0,5,0,0,0,1,98878
36,89864,3877,0,93741,80438,4204,558,127,128,1,3518,685,3280,924,3198,718,9426,8502,1,0,1,0,6,0,0,1,5,0,0,0,1,98807
37,88046,3855,0,91901,79004,4015,448,132,133,1,3434,580,3140,875,3127,593,9042,8167,1,0,1,0,6,0,0,1,5,0,0,0,1,98733
38,86571,3576,0,90147,77869,3708,387,111,112,1,3209,498,2907,801,3116,573,8702,7901,1,0,1,0,7,0,0,1,6,0,0,0,1,98656
39,87064,3707,0,90771,78886,3614,411,104,105,1,3098,515,2863,751,3037,498,8178,7427,1,0,1,0,7,0,0,1,6,0,0,0,1,98574
40,85289,3565,0,88854,77598,3391,342,91,91,0,2958,433,2717,674,2851,447,7691,7017,1,0,1,0,8,0,0,1,7,0,0,0,1,98488
41,83747,3537,0,87284,76447,3390,323,75,77,2,2990,398,2734,656,2731,414,7300,6644,2,0,2,0,8,0,0,2,8,0,0,0,0,98397
42,84005,3636,0,87641,76879,3440,349,103,104,1,2987,452,2775,665,2618,370,7126,6461,1,0,1,0,9,0,0,0,9,1,0,0,0,98303
43,82258,3423,0,85681,75147,3256,334,102,103,1,2819,436,2662,594,2651,344,7111,6517,1,0,1,0,10,0,0,0,9,1,0,1,0,98181
44,80823,3458,0,84281,73934,3111,301,87,89,2,2721,388,2544,567,2658,314,6889,6322,2,1,2,0,10,1,0,2,9,0,0,0,1,98074
45,81134,3466,0,84600,74475,3142,312,86,88,2,2742,398,2578,564,2519,323,6659,6095,4,0,4,0,12,0,0,3,11,1,0,0,1,97957
46,79331,3304,0,82635,72828,2965,246,94,94,0,2625,340,2437,528,2409,328,6503,5975,0,0,0,0,14,0,0,0,12,0,0,1,1,97831
47,77894,3224,0,81118,71567,2906,238,95,95,0,2573,333,2346,560,2434,305,6327,5767,0,0,0,0,14,0,0,0,12,0,0,0,2,97657
48,77944,3161,0,81105,71920,2774,157,80,83,3,2534,237,2297,477,2318,328,6024,5547,3,0,3,0,14,0,0,3,12,0,0,0,2,97505
49,76177,3067,0,79244,70363,2596,162,63,65,2,2369,225,2128,468,2313,269,5814,5346,2,0,2,0,16,0,0,1,14,1,0,0,2,97336
50,74759,3035,0,77794,69316,2446,97,37,37,0,2312,134,2034,412,2269,253,5443,5031,0,1,0,0,17,1,0,0,15,0,0,0,2,97151
51,75236,3082,0,78318,70136,2403,83,48,49,1,2271,131,2033,370,2136,186,5100,4730,1,0,1,0,16,0,0,0,14,1,0,0,2,96944
52,75322,3030,0,78352,70342,2548,104,85,86,1,2358,189,2126,422,2111,185,4980,4558,2,1,2,0,16,1,0,2,13,0,0,1,2,96706
53,75357,3130,0,78487,70424,2390,88,78,81,3,2221,166,2017,373,2032,125,4933,4560,4,0,4,0,16,0,0,3,14,1,0,0,2,96442
54,75486,3170,0,78656,70559,2458,80,83,86,3,2292,163,2081,377,2143,114,4927,4550,5,1,5,0,19,1,0,4,16,1,0,1,2,96149
55,75313,3037,0,78350,70463,2274,80,81,83,2,2111,161,1910,364,2007,130,4850,4486,3,3,3,0,22,3,0,3,18,0,0,1,3,95819
56,75116,3026,0,78142,70344,2392,83,83,86,3,2223,166,2035,357,2106,123,4772,4415,3,3,3,0,20,3,0,1,18,2,0,0,2,95406
57,74795,2965,0,77760,70113,2328,62,78,82,4,2184,140,1995,333,1919,131,4682,4349,6,0,6,0,20,0,0,5,17,1,0,2,1,94999
58,74471,3046,0,77517,69748,2241,54,60,64,4,2123,114,1912,329,2057,98,4723,4394,4,2,4,0,25,2,0,4,21,0,0,1,3,94554
59,74250,3016,0,77266,69651,2300,56,76,79,3,2165,132,1949,351,1999,138,4599,4248,3,3,3,0,24,3,0,2,21,1,0,0,3,94056
60,73929,3031,0,76960,69402,2313,53,80,83,3,2177,133,1992,321,1935,116,4527,4206,3,0,3,0,21,0,0,2,19,1,0,1,1,93519
61,73433,2878,0,76311,68853,2231,58,63,64,1,2109,121,1882,349,1980,95,4580,4231,2,1,2,0,23,1,0,2,20,0,0,1,2,92943
62,73018,2992,0,76010,68559,2229,57,55,56,1,2116,112,1909,320,1958,91,4459,4139,1,0,1,0,24,0,0,0,22,1,0,0,2,92303
63,72521,2926,0,75447,68114,2158,30,54,58,4,2070,84,1844,314,1908,97,4407,4093,4,0,4,0,22,0,0,4,19,0,0,1,2,91574
64,71800,2895,0,74695,67471,2159,38,59,62,3,2059,97,1845,314,1912,99,4329,4015,3,0,3,0,26,0,0,2,23,1,0,0,3,90724
65,71081,2810,0,73891,66830,2127,35,45,48,3,2044,80,1843,284,1891,75,4251,3967,4,0,0,4,29,0,0,3,25,1,0,1,3,89773
66,70215,2830,0,73045,66026,2030,19,71,71,0,1940,90,1736,294,1868,88,4189,3895,2,2,0,2,32,0,2,0,28,2,0,1,3,88693
67,69285,2812,0,72097,65252,1984,27,49,52,3,1905,76,1708,276,1836,68,4033,3757,4,1,0,4,28,0,1,4,24,0,0,1,3,87520
68,68275,2730,0,71005,64371,1972,25,55,56,1,1891,80,1713,259,1748,60,3904,3645,1,0,0,1,29,0,0,1,25,0,0,0,4,86283
69,67203,2647,0,69850,63369,2013,15,48,50,2,1948,63,1764,249,1710,60,3834,3585,3,2,0,3,28,0,2,1,25,2,0,0,3,85007
70,66139,2640,0,68779,62278,1828,17,43,46,3,1765,60,1574,254,1710,61,3861,3607,4,1,0,4,30,0,1,2,26,2,0,1,3,83672
71,65075,2655,0,67730,61362,1927,18,56,57,1,1852,74,1677,250,1750,54,3713,3463,1,1,0,1,32,0,1,0,28,1,0,2,2,82298
72,63932,2508,0,66440,60282,1887,15,61,62,1,1810,76,1628,259,1597,50,3650,3391,1,1,0,1,27,0,1,1,24,0,0,1,2,80842
73,62748,2531,0,65279,59100,1840,11,46,46,0,1783,57,1588,252,1643,54,3648,3396,2,2,0,2,25,0,2,2,22,0,0,0,3,79316
74,61527,2452,0,63979,57979,1740,11,40,42,2,1687,51,1512,228,1599,49,3548,3320,2,1,0,2,21,0,1,2,19,0,0,0,2,77682
75,60371,2449,0,62820,56957,1678,12,32,34,2,1632,44,1450,228,1584,57,3414,3186,4,3,0,4,19,0,3,1,17,3,0,0,2,75943
76,3826,24,0,3850,732,223,1,3,3,0,219,4,21,202,1445,39,3094,2892,1,4,0,1,18,0,4,1,14,0,0,2,2,74115
77,2322,29,0,2351,645,140,1,3,4,1,135,4,20,120,1380,29,1677,1557,2,2,0,2,13,0,2,0,11,2,0,0,2,72191
78,966,38,0,1004,591,44,0,2,2,0,42,2,19,25,191,40,375,350,0,3,0,0,12,0,3,0,9,0,0,1,2,70170
79,713,22,0,735,534,20,1,2,2,0,17,3,9,11,122,8,179,168,1,3,0,1,9,0,3,0,7,0,1,0,2,68047
80,529,17,0,546,469,22,0,0,0,0,22,0,20,2,38,1,60,58,1,0,0,1,6,0,0,0,5,1,0,0,1,65847
81,509,15,0,524,467,17,0,1,1,0,16,1,14,3,13,1,42,39,2,0,0,2,7,0,0,0,5,1,1,1,1,63570
82,423,19,0,442,379,12,1,2,2,0,9,3,10,2,20,4,44,42,2,1,0,2,5,0,1,1,3,1,0,1,1,61154
83,400,20,0,420,372,14,0,0,0,0,14,0,10,4,15,1,28,24,2,1,0,2,5,0,1,0,3,2,0,1,1,58606
84,384,15,0,399,361,8,0,0,0,0,8,0,7,1,7,1,23,22,3,1,0,3,4,0,1,3,2,0,0,2,0,55916
85,288,8,0,296,266,6,0,0,0,0,6,0,4,2,13,1,22,20,4,1,0,4,6,0,1,0,4,3,1,0,2,53061
86,277,7,0,284,263,6,0,0,0,0,6,0,5,1,8,0,14,13,4,1,0,4,9,0,1,2,4,2,0,4,1,50052
87,257,11,0,268,245,2,0,0,0,0,2,0,2,0,6,0,12,12,3,1,0,3,9,0,1,0,4,3,0,1,4,46894
88,199,3,0,202,193,5,0,0,0,0,5,0,5,0,4,0,6,6,3,1,0,3,12,0,1,0,4,2,1,3,5,43711
89,160,9,0,169,153,6,0,1,1,0,5,1,5,1,2,0,7,6,3,2,0,3,12,0,2,0,3,2,1,2,7,40379
90,158,4,0,162,150,7,0,0,0,0,7,0,7,0,3,0,8,8,3,2,0,3,12,0,2,0,3,1,2,2,7,36945
91,123,7,0,130,112,3,0,0,0,0,3,0,2,1,5,0,11,10,4,2,0,4,11,0,2,1,3,1,2,1,7,33481
92,101,3,0,104,94,2,0,0,0,0,2,0,2,0,5,0,7,7,1,2,0,1,13,0,2,0,4,1,0,2,7,30019
93,94,4,0,98,90,3,0,0,0,0,3,0,3,0,2,0,4,4,4,1,0,4,10,0,1,2,2,2,0,1,7,26583
94,56,1,0,57,51,1,0,0,0,0,1,0,1,0,2,0,5,5,1,1,0,1,11,0,1,0,4,1,0,2,5,23272
95,47,3,0,50,44,1,0,0,0,0,1,0,1,0,2,0,3,3,4,1,0,4,10,0,1,1,4,3,0,1,5,20113
96,48,3,0,51,46,0,0,0,0,0,0,0,0,0,1,0,2,2,1,0,0,1,11,0,0,0,4,1,0,3,4,17197
97,26,1,0,27,25,2,0,0,0,0,2,0,2,0,1,0,1,1,1,1,0,1,9,0,1,0,4,0,1,1,4,14535
98,25,0,0,25,23,0,0,0,0,0,0,0,0,0,0,0,2,2,1,0,0,1,8,0,0,0,4,1,0,0,4,12115
99,24,0,0,24,22,0,0,0,0,0,0,0,0,0,2,0,2,2,4,0,0,4,6,0,0,2,3,1,1,0,3,0
100,0,0,0,0,0,0,0,0,0,0,0,0,0,0,0,0,0,0,0,0,0,0,0,0,0,0,0,0,0,0,0,0
